+--+--+--+--+
|           |
+  +--+  +  +
|        |s |
+  +  +--+--+
|  |        |
+--+--+  +  +
|        |  |
+- +--+--+- +
|  |        |
+- +--+ -+--+
|  |g       |
+--+--+--+--+