+--+--+--+--+
|s |        |
+  +--+  +  +
|        |  |
+  +  +--+--+
|  |        |
+--+--+  +  +
|g       |  |
+--+--+--+--+